TTTTTTTTTTTTTTTTTTTTTTTTTTTTTTTTT
TTTTTTTTTTTTTTTTTTTTTTTTTTTTTTTTT
TOOOOOOOOOOOOOOTTOOOOOOOOOOOOOOOT
TOTTTTTTOTTTTTOTTOTTTTTTTTOTTTTOT
TOOOOOOOOOOOOOOOOOOOOOOOOOOTTTTOT
TTTTTTOTTOTTTTTTTTTTTTTOTTOOOOOOT
XXXXXTOTTOTTTTTTTTTTTTTOTTOTTTTTT
XXXXXTOTTOOOOOOTTOOOOOOOTTOTXXXXX
XXXXXTOTTOTTTTOTTOTTTTTOTTOTXXXXX
XXXXXTOTTOOOOOOOOOOOOOOOTTOTXXXXX
TTTTTTOTTOTTTTTOOOTTTTTOTTOTTTTTT
TOOOOOOOOOTOOOOOOOOOOOTOOOOOOOOOT
TTTTTTOTTOTOOOOOOOOOOOTOTTOTTTTTT
XXXXXTOTTOTOOOOOOOOOOOTOTTOTXXXXX
XXXXXTOTTOTTTTTTTTTTTTTOTTOTXXXXX
XXXXXTOTTOOOOOOOOOOOOOOOTTOTXXXXX
TTTTTTOTTOTTTTTTTTTTTTTOTTOTXXXXX
TOOOOOOTTOTTTTTTTTTTTTTOTTOTTTTTT
TOTTTTOOOOOOOOOOOOOOOOOOOOOOOOOOT
TOOOOTOTOTTTTTTOTTTTTTTOTTOTOTTTT
TTTTOTOTOOOOOOOOOOOOOOOOTTOTOTTTT
TOOOOOOTTTTTTTTOTTTTTTTOTTOTOTTTT
TOTTTTTTTTTTTTTOTTTTTTTOTTOTOOOOT
TOOOOOOOOOOOOOOOOOOOOOOOOOOOOOOOT
TTTTTTTTTTTTTTTTTTTTTTTTTTTTTTTTT
XXXXXXXXXXXXXXXXXXXXXXXXXXXXXXXXX